闽	福建省
北京	北京市
天津	天津市
河北	河北省
山西	山西省
内蒙古	内蒙古自治区
辽宁	辽宁省
吉林	吉林省
黑龙江	黑龙江省
上海	上海市
江苏	江苏省
浙江	浙江省
安徽	安徽省
福建	福建省
江西	江西省
山东	山东省
河南	河南省
湖北	湖北省
湖南	湖南省
广东	广东省
广西	广西壮族自治区
海南	海南省
重庆	重庆市
四川	四川省
贵州	贵州省
云南	云南省
西藏	西藏自治区
陕西	陕西省
甘肃	甘肃省
青海	青海省
宁夏	宁夏回族自治区
新疆	新疆维吾尔自治区
香港	香港特别行政区
澳门	澳门特别行政区
石家庄	河北省石家庄市
保定	河北省保定市
沧州	河北省沧州市
承德	河北省承德市
邯郸	河北省邯郸市
衡水	河北省衡水市
廊坊	河北省廊坊市
唐山	河北省唐山市
邢台	河北省邢台市
秦皇岛	河北省秦皇岛市
张家口	河北省张家口市
太原	山西省太原市
长治	山西省长治市
大同	山西省大同市
晋城	山西省晋城市
晋中	山西省晋中市
临汾	山西省临汾市
吕梁	山西省吕梁市
朔州	山西省朔州市
忻州	山西省忻州市
阳泉	山西省阳泉市
运城	山西省运城市
呼和浩特	内蒙古自治区呼和浩特市
包头	内蒙古自治区包头市
赤峰	内蒙古自治区赤峰市
通辽	内蒙古自治区通辽市
乌海	内蒙古自治区乌海市
巴彦淖尔	内蒙古自治区巴彦淖尔市
鄂尔多斯	内蒙古自治区鄂尔多斯市
呼伦贝尔	内蒙古自治区呼伦贝尔市
乌兰察布	内蒙古自治区乌兰察布市
兴安	内蒙古自治区兴安盟
阿拉善	内蒙古自治区阿拉善盟
锡林郭勒	内蒙古自治区锡林郭勒盟
沈阳	辽宁省沈阳市
大连	辽宁省大连市
鞍山	辽宁省鞍山市
本溪	辽宁省本溪市
朝阳	辽宁省朝阳市
丹东	辽宁省丹东市
抚顺	辽宁省抚顺市
阜新	辽宁省阜新市
锦州	辽宁省锦州市
辽阳	辽宁省辽阳市
盘锦	辽宁省盘锦市
铁岭	辽宁省铁岭市
营口	辽宁省营口市
葫芦岛	辽宁省葫芦岛市
长春	吉林省长春市
白城	吉林省白城市
白山	吉林省白山市
吉林市	吉林省吉林市
辽源	吉林省辽源市
四平	吉林省四平市
松原	吉林省松原市
通化	吉林省通化市
延边	吉林省延边朝鲜族自治州
哈尔滨	黑龙江省哈尔滨市
大庆	黑龙江省大庆市
鹤岗	黑龙江省鹤岗市
黑河	黑龙江省黑河市
绥化	黑龙江省绥化市
鸡西	黑龙江省鸡西市
伊春	黑龙江省伊春市
佳木斯	黑龙江省佳木斯市
牡丹江	黑龙江省牡丹江市
七台河	黑龙江省七台河市
双鸭山	黑龙江省双鸭山市
齐齐哈尔	黑龙江省齐齐哈尔市
大兴安岭	黑龙江省大兴安岭地区
南京	江苏省南京市
常州	江苏省常州市
淮安	江苏省淮安市
南通	江苏省南通市
苏州	江苏省苏州市
宿迁	江苏省宿迁市
泰州	江苏省泰州市
无锡	江苏省无锡市
徐州	江苏省徐州市
盐城	江苏省盐城市
扬州	江苏省扬州市
镇江	江苏省镇江市
连云港	江苏省连云港市
杭州	浙江省杭州市
湖州	浙江省湖州市
嘉兴	浙江省嘉兴市
金华	浙江省金华市
丽水	浙江省丽水市
宁波	浙江省宁波市
绍兴	浙江省绍兴市
台州	浙江省台州市
温州	浙江省温州市
舟山	浙江省舟山市
衢州	浙江省衢州市
合肥	安徽省合肥市
安庆	安徽省安庆市
蚌埠	安徽省蚌埠市
池州	安徽省池州市
滁州	安徽省滁州市
阜阳	安徽省阜阳市
淮北	安徽省淮北市
淮南	安徽省淮南市
黄山	安徽省黄山市
六安	安徽省六安市
宿州	安徽省宿州市
铜陵	安徽省铜陵市
芜湖	安徽省芜湖市
宣城	安徽省宣城市
亳州	安徽省亳州市
马鞍山	安徽省马鞍山市
福州	福建省福州市
龙岩	福建省龙岩市
南平	福建省南平市
宁德	福建省宁德市
莆田	福建省莆田市
泉州	福建省泉州市
三明	福建省三明市
厦门	福建省厦门市
漳州	福建省漳州市
南昌	江西省南昌市
抚州	江西省抚州市
赣州	江西省赣州市
吉安	江西省吉安市
九江	江西省九江市
萍乡	江西省萍乡市
上饶	江西省上饶市
新余	江西省新余市
宜春	江西省宜春市
鹰潭	江西省鹰潭市
景德镇	江西省景德镇市
济南	山东省济南市
滨州	山东省滨州市
德州	山东省德州市
东营	山东省东营市
菏泽	山东省菏泽市
济宁	山东省济宁市
莱芜	山东省莱芜市
聊城	山东省聊城市
临沂	山东省临沂市
青岛	山东省青岛市
日照	山东省日照市
泰安	山东省泰安市
威海	山东省威海市
潍坊	山东省潍坊市
烟台	山东省烟台市
枣庄	山东省枣庄市
淄博	山东省淄博市
郑州	河南省郑州市
安阳	河南省安阳市
鹤壁	河南省鹤壁市
焦作	河南省焦作市
济源	河南省济源市
开封	河南省开封市
洛阳	河南省洛阳市
南阳	河南省南阳市
商丘	河南省商丘市
新乡	河南省新乡市
信阳	河南省信阳市
许昌	河南省许昌市
周口	河南省周口市
漯河	河南省漯河市
濮阳	河南省濮阳市
三门峡	河南省三门峡市
平顶山	河南省平顶山市
驻马店	河南省驻马店市
武汉	湖北省武汉市
鄂州	湖北省鄂州市
黄冈	湖北省黄冈市
黄石	湖北省黄石市
荆门	湖北省荆门市
荆州	湖北省荆州市
十堰	湖北省十堰市
随州	湖北省随州市
咸宁	湖北省咸宁市
襄阳	湖北省襄阳市
孝感	湖北省孝感市
宜昌	湖北省宜昌市
神农架	湖北省神农架林区
潜江	湖北省潜江市
天门	湖北省天门市
仙桃	湖北省仙桃市
恩施	湖北省恩施土家族苗族自治州
长沙	湖南省长沙市
常德	湖南省常德市
郴州	湖南省郴州市
衡阳	湖南省衡阳市
怀化	湖南省怀化市
娄底	湖南省娄底市
邵阳	湖南省邵阳市
湘潭	湖南省湘潭市
益阳	湖南省益阳市
永州	湖南省永州市
岳阳	湖南省岳阳市
株洲	湖南省株洲市
张家界	湖南省张家界市
湘西	湖南省湘西土家族苗族自治州
广州	广东省广州市
东莞	广东省东莞市
潮州	广东省潮州市
佛山	广东省佛山市
河源	广东省河源市
惠州	广东省惠州市
江门	广东省江门市
揭阳	广东省揭阳市
茂名	广东省茂名市
梅州	广东省梅州市
清远	广东省清远市
汕头	广东省汕头市
汕尾	广东省汕尾市
韶关	广东省韶关市
深圳	广东省深圳市
阳江	广东省阳江市
云浮	广东省云浮市
湛江	广东省湛江市
肇庆	广东省肇庆市
中山	广东省中山市
珠海	广东省珠海市
南宁	广西壮族自治区南宁市
百色	广西壮族自治区百色市
北海	广西壮族自治区北海市
崇左	广西壮族自治区崇左市
桂林	广西壮族自治区桂林市
贵港	广西壮族自治区贵港市
河池	广西壮族自治区河池市
贺州	广西壮族自治区贺州市
来宾	广西壮族自治区来宾市
柳州	广西壮族自治区柳州市
钦州	广西壮族自治区钦州市
梧州	广西壮族自治区梧州市
玉林	广西壮族自治区玉林市
防城港	广西壮族自治区防城港市
海口	海南省海口市
三亚	海南省三亚市
白沙	海南省白沙黎族自治县
保亭	海南省保亭黎族苗族自治县
昌江	海南省昌江黎族自治县
儋州	海南省儋州市
东方	海南省东方市
乐东	海南省乐东黎族自治县
陵水	海南省陵水黎族自治县
琼海	海南省琼海市
琼中	海南省琼中黎族苗族自治县
万宁	海南省万宁市
文昌	海南省文昌市
五指山	海南省五指山市
三沙	海南省三沙市
成都	四川省成都市
巴中	四川省巴中市
达州	四川省达州市
德阳	四川省德阳市
广安	四川省广安市
广元	四川省广元市
乐山	四川省乐山市
眉山	四川省眉山市
绵阳	四川省绵阳市
南充	四川省南充市
内江	四川省内江市
遂宁	四川省遂宁市
雅安	四川省雅安市
宜宾	四川省宜宾市
资阳	四川省资阳市
自贡	四川省自贡市
泸州	四川省泸州市
攀枝花	四川省攀枝花市
甘孜	四川省甘孜藏族自治州
凉山	四川省凉山彝族自治州
阿坝	四川省阿坝藏族羌族自治州
贵阳	贵州省贵阳市
安顺	贵州省安顺市
遵义	贵州省遵义市
六盘水	贵州省六盘水市
铜仁	贵州省铜仁市
毕节	贵州省毕节市
黔东南	贵州省黔东南苗族侗族自治州
黔南	贵州省黔南布依族苗族自治州
黔西南	贵州省黔西南布依族苗族自治州
昆明	云南省昆明市
保山	云南省保山市
丽江	云南省丽江市
普洱	云南省普洱市
临沧	云南省临沧市
曲靖	云南省曲靖市
玉溪	云南省玉溪市
昭通	云南省昭通市
楚雄	云南省楚雄彝族自治州
迪庆	云南省迪庆藏族自治州
大理	云南省大理白族自治州
文山	云南省文山壮族苗族自治州
怒江	云南省怒江傈僳族自治州
西双版纳	云南省西双版纳傣族自治州
德宏傣族景颇族	云南省德宏傣族景颇族自治州
红河哈尼族	云南省红河哈尼族彝族自治州
拉萨	西藏自治区拉萨市
阿里	西藏自治区阿里地区
昌都	西藏自治区昌都市
林芝	西藏自治区林芝地区
那曲	西藏自治区那曲地区
山南	西藏自治区山南地区
日喀则	西藏自治区日喀则市
西安	陕西省西安市
宝鸡	陕西省宝鸡市
安康	陕西省安康市
汉中	陕西省汉中市
商洛	陕西省商洛市
铜川	陕西省铜川市
渭南	陕西省渭南市
咸阳	陕西省咸阳市
延安	陕西省延安市
榆林	陕西省榆林市
兰州	甘肃省兰州市
白银	甘肃省白银市
定西	甘肃省定西市
陇南	甘肃省陇南市
金昌	甘肃省金昌市
酒泉	甘肃省酒泉市
庆阳	甘肃省庆阳市
天水	甘肃省天水市
武威	甘肃省武威市
张掖	甘肃省张掖市
平凉	甘肃省平凉市
嘉峪关	甘肃省嘉峪关市
临夏	甘肃省临夏回族自治州
甘南	甘肃省甘南藏族自治州
西宁	青海省西宁市
海东	青海省海东市
果洛	青海省果洛藏族自治州
海北	青海省海北藏族自治州
海南	青海省海南藏族自治州
黄南	青海省黄南藏族自治州
玉树	青海省玉树藏族自治州
海西蒙古族	青海省海西蒙古族藏族自治州
银川	宁夏回族自治区银川市
固原	宁夏回族自治区固原市
吴忠	宁夏回族自治区吴忠市
中卫	宁夏回族自治区中卫市
石嘴山	宁夏回族自治区石嘴山市
乌鲁木齐	新疆维吾尔自治区乌鲁木齐市
石河子	新疆维吾尔自治区石河子市
克拉玛依	新疆维吾尔自治区克拉玛依市
哈密	新疆维吾尔自治区哈密地区
和田	新疆维吾尔自治区和田地区
塔城	新疆维吾尔自治区塔城地区
喀什	新疆维吾尔自治区喀什地区
阿克苏	新疆维吾尔自治区阿克苏地区
阿勒泰	新疆维吾尔自治区阿勒泰地区
吐鲁番	新疆维吾尔自治区吐鲁番地区
阿拉尔	新疆维吾尔自治区阿拉尔市
五家渠	新疆维吾尔自治区五家渠市
图木舒克	新疆维吾尔自治区图木舒克市
北屯	新疆维吾尔自治区北屯市
铁门关	新疆维吾尔自治区铁门关市
双河	新疆维吾尔自治区双河市
昌吉	新疆维吾尔自治区昌吉回族自治州
伊犁哈萨克	新疆维吾尔自治区伊犁哈萨克自治州
巴音郭楞	新疆维吾尔自治区巴音郭楞蒙古自治州
博尔塔拉	新疆维吾尔自治区博尔塔拉蒙古自治州
克孜勒苏柯尔克孜	新疆维吾尔自治区克孜勒苏柯尔克孜自治州
台北	台湾台北市
新北	台湾新北市
台中	台湾台中市
台南	台湾台南市
高雄	台湾高雄市
基隆	台湾基隆市
新竹	台湾新竹市
嘉义	台湾嘉义市