闽	福建省
北京	北京市
天津	天津市
河北	河北省
山西	山西省
内蒙古	内蒙古自治区
辽宁	辽宁省
吉林	吉林省
黑龙江	黑龙江省
上海	上海市
江苏	江苏省
浙江	浙江省
安徽	安徽省
福建	福建省
江西	江西省
山东	山东省
河南	河南省
湖北	湖北省
湖南	湖南省
广东	广东省
广西	广西壮族自治区
海南	海南省
重庆	重庆市
四川	四川省
贵州	贵州省
云南	云南省
西藏	西藏自治区
陕西	陕西省
甘肃	甘肃省
青海	青海省
宁夏	宁夏回族自治区
新疆	新疆维吾尔自治区
香港	香港特别行政区
澳门	澳门特别行政区
北京	北京市
天津	天津市
石家庄	石家庄市
保定	保定市
沧州	沧州市
承德	承德市
邯郸	邯郸市
衡水	衡水市
廊坊	廊坊市
唐山	唐山市
邢台	邢台市
秦皇岛	秦皇岛市
张家口	张家口市
太原	太原市
长治	长治市
大同	大同市
晋城	晋城市
晋中	晋中市
临汾	临汾市
吕梁	吕梁市
朔州	朔州市
忻州	忻州市
阳泉	阳泉市
运城	运城市
呼和浩特	呼和浩特市
包头	包头市
赤峰	赤峰市
通辽	通辽市
乌海	乌海市
巴彦淖尔	巴彦淖尔市
鄂尔多斯	鄂尔多斯市
呼伦贝尔	呼伦贝尔市
乌兰察布	乌兰察布市
兴安	兴安盟
阿拉善	阿拉善盟
锡林郭勒	锡林郭勒盟
沈阳	沈阳市
大连	大连市
鞍山	鞍山市
本溪	本溪市
朝阳	朝阳市
丹东	丹东市
抚顺	抚顺市
阜新	阜新市
锦州	锦州市
辽阳	辽阳市
盘锦	盘锦市
铁岭	铁岭市
营口	营口市
葫芦岛	葫芦岛市
长春	长春市
白城	白城市
白山	白山市
吉林	吉林市
辽源	辽源市
四平	四平市
松原	松原市
通化	通化市
延边	延边朝鲜族自治州
哈尔滨	哈尔滨市
大庆	大庆市
鹤岗	鹤岗市
黑河	黑河市
绥化	绥化市
鸡西	鸡西市
伊春	伊春市
佳木斯	佳木斯市
牡丹江	牡丹江市
七台河	七台河市
双鸭山	双鸭山市
齐齐哈尔	齐齐哈尔市
大兴安岭	大兴安岭地区
上海	上海市
南京	南京市
常州	常州市
淮安	淮安市
南通	南通市
苏州	苏州市
宿迁	宿迁市
泰州	泰州市
无锡	无锡市
徐州	徐州市
盐城	盐城市
扬州	扬州市
镇江	镇江市
连云港	连云港市
杭州	杭州市
湖州	湖州市
嘉兴	嘉兴市
金华	金华市
丽水	丽水市
宁波	宁波市
绍兴	绍兴市
台州	台州市
温州	温州市
舟山	舟山市
衢州	衢州市
合肥	合肥市
安庆	安庆市
蚌埠	蚌埠市
池州	池州市
滁州	滁州市
阜阳	阜阳市
淮北	淮北市
淮南	淮南市
黄山	黄山市
六安	六安市
宿州	宿州市
铜陵	铜陵市
芜湖	芜湖市
宣城	宣城市
亳州	亳州市
马鞍山	马鞍山市
福州	福州市
龙岩	龙岩市
南平	南平市
宁德	宁德市
莆田	莆田市
泉州	泉州市
三明	三明市
厦门	厦门市
漳州	漳州市
南昌	南昌市
抚州	抚州市
赣州	赣州市
吉安	吉安市
九江	九江市
萍乡	萍乡市
上饶	上饶市
新余	新余市
宜春	宜春市
鹰潭	鹰潭市
景德镇	景德镇市
济南	济南市
滨州	滨州市
德州	德州市
东营	东营市
菏泽	菏泽市
济宁	济宁市
莱芜	莱芜市
聊城	聊城市
临沂	临沂市
青岛	青岛市
日照	日照市
泰安	泰安市
威海	威海市
潍坊	潍坊市
烟台	烟台市
枣庄	枣庄市
淄博	淄博市
郑州	郑州市
安阳	安阳市
鹤壁	鹤壁市
焦作	焦作市
济源	济源市
开封	开封市
洛阳	洛阳市
南阳	南阳市
商丘	商丘市
新乡	新乡市
信阳	信阳市
许昌	许昌市
周口	周口市
漯河	漯河市
濮阳	濮阳市
三门峡	三门峡市
平顶山	平顶山市
驻马店	驻马店市
武汉	武汉市
鄂州	鄂州市
黄冈	黄冈市
黄石	黄石市
荆门	荆门市
荆州	荆州市
十堰	十堰市
随州	随州市
咸宁	咸宁市
襄阳	襄阳市
孝感	孝感市
宜昌	宜昌市
神农架	神农架林区
潜江	潜江市
天门	天门市
仙桃	仙桃市
恩施	恩施土家族苗族自治州
长沙	长沙市
常德	常德市
郴州	郴州市
衡阳	衡阳市
怀化	怀化市
娄底	娄底市
邵阳	邵阳市
湘潭	湘潭市
益阳	益阳市
永州	永州市
岳阳	岳阳市
株洲	株洲市
张家界	张家界市
湘西	湘西土家族苗族自治州
广州	广州市
东莞	东莞市
潮州	潮州市
佛山	佛山市
河源	河源市
惠州	惠州市
江门	江门市
揭阳	揭阳市
茂名	茂名市
梅州	梅州市
清远	清远市
汕头	汕头市
汕尾	汕尾市
韶关	韶关市
深圳	深圳市
阳江	阳江市
云浮	云浮市
湛江	湛江市
肇庆	肇庆市
中山	中山市
珠海	珠海市
南宁	南宁市
百色	百色市
北海	北海市
崇左	崇左市
桂林	桂林市
贵港	贵港市
河池	河池市
贺州	贺州市
来宾	来宾市
柳州	柳州市
钦州	钦州市
梧州	梧州市
玉林	玉林市
防城港	防城港市
海口	海口市
三亚	三亚市
白沙	白沙黎族自治县
保亭	保亭黎族苗族自治县
昌江	昌江黎族自治县
儋州	儋州市
东方	东方市
乐东	乐东黎族自治县
陵水	陵水黎族自治县
琼海	琼海市
琼中	琼中黎族苗族自治县
万宁	万宁市
文昌	文昌市
五指山	五指山市
三沙	三沙市
重庆	重庆市
成都	成都市
巴中	巴中市
达州	达州市
德阳	德阳市
广安	广安市
广元	广元市
乐山	乐山市
眉山	眉山市
绵阳	绵阳市
南充	南充市
内江	内江市
遂宁	遂宁市
雅安	雅安市
宜宾	宜宾市
资阳	资阳市
自贡	自贡市
泸州	泸州市
攀枝花	攀枝花市
甘孜	甘孜藏族自治州
凉山	凉山彝族自治州
阿坝	阿坝藏族羌族自治州
贵阳	贵阳市
安顺	安顺市
遵义	遵义市
六盘水	六盘水市
铜仁	铜仁市
毕节	毕节市
黔东南	黔东南苗族侗族自治州
黔南	黔南布依族苗族自治州
黔西南	黔西南布依族苗族自治州
昆明	昆明市
保山	保山市
丽江	丽江市
普洱	普洱市
临沧	临沧市
曲靖	曲靖市
玉溪	玉溪市
昭通	昭通市
楚雄	楚雄彝族自治州
迪庆	迪庆藏族自治州
大理	大理白族自治州
文山	文山壮族苗族自治州
怒江	怒江傈僳族自治州
西双版纳	西双版纳傣族自治州
德宏傣族景颇族	德宏傣族景颇族自治州
红河哈尼族	红河哈尼族彝族自治州
拉萨	拉萨市
阿里	阿里地区
昌都	昌都市
林芝	林芝地区
那曲	那曲地区
山南	山南地区
日喀则	日喀则市
西安	西安市
宝鸡	宝鸡市
安康	安康市
汉中	汉中市
商洛	商洛市
铜川	铜川市
渭南	渭南市
咸阳	咸阳市
延安	延安市
榆林	榆林市
兰州	兰州市
白银	白银市
定西	定西市
陇南	陇南市
金昌	金昌市
酒泉	酒泉市
庆阳	庆阳市
天水	天水市
武威	武威市
张掖	张掖市
平凉	平凉市
嘉峪关	嘉峪关市
临夏	临夏回族自治州
甘南	甘南藏族自治州
西宁	西宁市
海东	海东市
果洛	果洛藏族自治州
海北	海北藏族自治州
海南	海南藏族自治州
黄南	黄南藏族自治州
玉树	玉树藏族自治州
海西蒙古族	海西蒙古族藏族自治州
银川	银川市
固原	固原市
吴忠	吴忠市
中卫	中卫市
石嘴山	石嘴山市
乌鲁木齐	乌鲁木齐市
石河子	石河子市
克拉玛依	克拉玛依市
哈密	哈密地区
和田	和田地区
塔城	塔城地区
喀什	喀什地区
阿克苏	阿克苏地区
阿勒泰	阿勒泰地区
吐鲁番	吐鲁番地区
阿拉尔	阿拉尔市
五家渠	五家渠市
图木舒克	图木舒克市
北屯	北屯市
铁门关	铁门关市
双河	双河市
昌吉	昌吉回族自治州
伊犁哈萨克	伊犁哈萨克自治州
巴音郭楞	巴音郭楞蒙古自治州
博尔塔拉	博尔塔拉蒙古自治州
克孜勒苏柯尔克孜	克孜勒苏柯尔克孜自治州
台北	台北市
新北	新北市
台中	台中市
台南	台南市
高雄	高雄市
基隆	基隆市
新竹	新竹市
嘉义	嘉义市